ดูแลตัวเอง	Take care of yourself

เปิดไฟ	light on
ปิดไฟ	lignt off

เหมือน	like (as)

จูบ	kiss

เท้า	foot
มือ	hand
แขน	arm
ขา	leg
กลับ	back
ท้อง	belly
คอ	neck

หี	pussy
ตูด	ass

Euphemisms for sexy: sexy, spicy, sour, delicious

วันนี้คุณดูเซ็กซี่มาก	Today you look very sexy.
คุณใส่ชุดนี้ตู้เพ็ทมาก	You wear this dress look very spicy.
คุนทาลิปสีแดงเปรี้ยวมาก	You ? lip red very sour. 
รองเท้าคู่นี้แซ่บมาก		This pair of shoes very amazing (delicious).
เย้ายวน	Seductive.
